000000000010000000000
011101111010111101110
000000000000000000000
011101011111110101110
000001000010000100000
111101111010111101111
111101000000000101111
111101011111110101111
000000011111110000000
111101011111110101111
111101000000000101111
111101011111110101111
000000000010000000000
011101111010111101110
000100000000000001000
110101011111110101011
000001000010000100000
011111111010111111110
000000000000000000000